##########
#        #
#o# ######
#  #  #   #
## # ##   #
#     #   #
# ### #   #
#     #   #
# ### #   #
#x        #
##########
